NO ./textures/wall1h.xpm
F 0,191, 252

SO ./textures/wall1v.xpm
WE ./textures/wall2h.xpm

EA ./textures/wall2v.xpm
S ./textures/cat.xpm
R 12000 6000
C 80,80,120

            1111111111
111111111111000001110000000000001
1100000011101011100000010001
100E0000000000021000000000001
11111111111111111111111111111

1111111111111101101111010001
        1     1  1
