NO ./textures/wall1h.xpm
F 0,191, 252

SO ./textures/wall1v.xpm
WE ./textures/wall2h.xpm
EA ./textures/wall2v.xpm
S ./textures/cat.xpm
R 1000 600
C 80,80,80

111111111111000001110000000000001
100000000000000111111111111111
11111111111111111100000010001
11110111111111011101010010001
11000000110101011100000010001
100200000000000000000000000001
10000000000000001101010010001
11000001110101011111011110N0111
11110111 1110101 101111010001
11111111 1111111 11111111111
