NO ./textures/wall1h.xpm
F 0,191, 252

SO ./textures/wall1v.xpm
WE ./textures/wall2h.xpm
EA ./textures/wall2v.xpm
S ./textures/cat.xpm
R 1000 600
C 80,80,120

            1111111111
111111111111000001110000000000001
1120W02011121011100000010001
10000000000000021000000000001
1111111111111101101111010001
        1     1  1
