NO  ./textures/wall1h.xpm
SO  ./textures/wall1v.xpm
WE  ./textures/wall2h.xpm
EA  ./textures/wall2v.xpm

S   ./textures/barrel.xpm

C     0, 255, 0
F   255,   0, 0

R   1200 600

        1111111111111111111111111
        1000000000110000000000001
        1011000001110000002000001
        1001000000000000000000001
111111111011000001110000000000001
100000000011000001110111111111111
11110111111111011100000010001
11110111111111011101010010001
11000000110101011100000010001
10002000000000001100000000201
10000000000000001101010010001
11000001110101011111011110N01
11110111 1110101 101111010001
11111111 1111111 111111111111
